{
  "rows": 20,
  "columns": 20,
  "terrains": [
    0, 0, 0, 0, 0, 0, 0, 0, 0, 0, 0, 0, 0, 0, 0, 0, 0, 0, 0, 0, 0, 0, 3, 0, 0,
    0, 0, 0, 0, 0, 0, 0, 2, 0, 0, 0, 0, 3, 0, 0, 0, 0, 0, 0, 0, 0, 1, 0, 0, 0,
    0, 0, 0, 1, 0, 0, 0, 2, 0, 0, 0, 0, 0, 0, 0, 0, 0, 0, 0, 0, 1, 3, 0, 0, 0,
    0, 0, 0, 0, 0, 2, 0, 0, 0, 0, 2, 0, 0, 0, 0, 0, 0, 0, 0, 0, 0, 0, 0, 0, 0,
    0, 0, 0, 0, 0, 0, 0, 0, 0, 0, 0, 0, 0, 3, 1, 0, 0, 0, 0, 0, 0, 0, 3, 0, 0,
    0, 3, 0, 0, 2, 0, 0, 0, 0, 3, 0, 0, 1, 0, 0, 0, 0, 0, 0, 0, 0, 0, 0, 0, 0,
    1, 0, 0, 0, 0, 0, 0, 0, 0, 0, 0, 0, 0, 0, 1, 0, 0, 0, 0, 0, 0, 0, 0, 0, 0,
    1, 0, 3, 0, 0, 0, 0, 0, 0, 0, 0, 0, 0, 0, 0, 0, 0, 0, 0, 0, 0, 0, 2, 0, 0,
    0, 0, 2, 0, 0, 0, 1, 0, 0, 0, 0, 3, 2, 0, 0, 0, 0, 0, 0, 0, 0, 0, 0, 0, 0,
    0, 0, 0, 0, 0, 0, 0, 0, 0, 0, 0, 0, 0, 0, 0, 0, 0, 0, 0, 3, 0, 0, 0, 0, 0,
    0, 0, 0, 0, 0, 0, 0, 0, 0, 0, 0, 0, 0, 0, 0, 0, 0, 0, 0, 1, 0, 3, 0, 0, 0,
    0, 0, 0, 0, 0, 0, 0, 1, 0, 0, 0, 2, 0, 0, 0, 0, 0, 1, 0, 0, 2, 1, 0, 3, 0,
    0, 0, 0, 0, 0, 0, 0, 0, 0, 0, 0, 0, 0, 0, 0, 0, 0, 0, 0, 0, 3, 0, 0, 0, 0,
    0, 0, 3, 0, 0, 0, 0, 0, 0, 0, 0, 0, 3, 0, 0, 0, 0, 0, 2, 0, 0, 0, 0, 0, 0,
    3, 1, 0, 0, 0, 0, 0, 2, 0, 0, 0, 0, 0, 0, 0, 0, 0, 0, 0, 0, 0, 0, 0, 0, 2,
    0, 0, 0, 0, 0, 0, 0, 0, 0, 3, 0, 0, 0, 0, 0, 0, 0, 0, 0, 0, 0, 0, 0, 0, 0
  ],
  "environments": [
    [95, 7, 5],
    [193, 14, 5],
    [139, 15, 6],
    [21, 18, 4],
    [262, 27, 4],
    [109, 44, 4],
    [278, 49, 6],
    [157, 27, 2],
    [250, 76, 5],
    [197, 81, 4],
    [8, 81, 6],
    [152, 85, 5],
    [22, 32, 0],
    [293, 116, 6],
    [230, 125, 4],
    [193, 126, 6],
    [44, 132, 5],
    [72, 69, 1],
    [188, 143, 5],
    [127, 147, 6],
    [10, 165, 6],
    [57, 176, 4],
    [128, 179, 4],
    [217, 184, 3],
    [242, 130, 1],
    [100, 218, 6],
    [150, 224, 5],
    [268, 236, 5],
    [37, 206, 2],
    [269, 253, 4],
    [164, 259, 4],
    [88, 249, 3],
    [21, 270, 4],
    [182, 207, 0],
    [126, 279, 6],
    [230, 289, 6]
  ],
  "organisms": [[148, 278, 0]],
  "interactions": [
    {
      "x": 100,
      "y": 16,
      "width": 16,
      "height": 16,
      "data": {
        "type": "switch-map",
        "map": "map-002",
        "playerX": 32,
        "playerY": 32
      }
    }
  ]
}
