{
  "rows": 21,
  "columns": 22,
  "terrains": [
    3, 3, 3, 4, 4, 3, 3, 3, 3, 3, 3, 3, 3, 4, 3, 4, 3, 3, 3, 3, 3, 3, 3, 3, 3,
    4, 4, 3, 3, 3, 3, 3, 3, 3, 3, 4, 3, 4, 3, 3, 3, 3, 3, 3, 3, 3, 3, 4, 4, 1,
    1, 1, 1, 1, 1, 1, 1, 4, 3, 4, 3, 3, 3, 3, 3, 3, 3, 3, 3, 4, 5, 0, 0, 10, 0,
    9, 0, 0, 0, 2, 1, 4, 3, 3, 3, 3, 3, 3, 3, 3, 3, 4, 14, 0, 0, 9, 0, 0, 0, 9,
    0, 0, 10, 2, 1, 1, 1, 1, 1, 1, 3, 3, 3, 4, 14, 0, 0, 0, 0, 0, 0, 0, 0, 0, 0,
    10, 0, 13, 16, 16, 16, 16, 1, 1, 1, 5, 0, 9, 0, 0, 0, 0, 0, 0, 0, 0, 0, 0,
    13, 0, 0, 10, 0, 0, 16, 16, 16, 16, 12, 0, 0, 0, 0, 0, 0, 0, 0, 0, 9, 15,
    14, 0, 9, 0, 0, 0, 0, 9, 10, 0, 15, 14, 0, 9, 0, 0, 0, 0, 0, 0, 0, 13, 0, 0,
    0, 0, 9, 0, 0, 0, 0, 0, 0, 12, 10, 0, 0, 0, 9, 0, 10, 0, 13, 0, 9, 0, 10, 0,
    0, 6, 0, 10, 0, 9, 0, 15, 14, 9, 0, 0, 0, 0, 0, 15, 8, 0, 0, 0, 0, 6, 7, 4,
    0, 9, 0, 0, 0, 6, 13, 16, 16, 12, 0, 10, 0, 15, 4, 7, 7, 7, 7, 4, 3, 4, 0,
    0, 0, 6, 7, 4, 14, 9, 0, 0, 12, 0, 9, 15, 4, 3, 3, 3, 3, 4, 1, 5, 7, 7, 7,
    4, 3, 4, 14, 0, 10, 0, 15, 14, 0, 0, 2, 1, 1, 11, 1, 5, 0, 0, 3, 3, 3, 4, 3,
    4, 14, 10, 0, 9, 15, 14, 9, 0, 0, 0, 9, 0, 0, 0, 9, 0, 3, 3, 3, 4, 3, 4, 8,
    0, 0, 0, 6, 14, 10, 0, 0, 0, 0, 0, 10, 0, 0, 0, 3, 3, 3, 4, 3, 4, 4, 7, 7,
    7, 4, 8, 0, 0, 9, 0, 0, 0, 6, 7, 7, 7, 3, 3, 3, 4, 3, 4, 4, 3, 3, 3, 4, 4,
    7, 8, 0, 0, 0, 6, 4, 3, 3, 3, 3, 3, 3, 4, 3, 4, 4, 3, 3, 3, 4, 4, 3, 4, 7,
    7, 7, 4, 4, 3, 3, 3, 3, 3, 3, 4, 3, 4, 4, 3, 3, 3, 4, 4, 3, 4, 3, 3, 3, 4,
    4, 3, 3, 3, 3, 3, 3, 4, 3, 4, 4, 3, 3, 3, 4, 4, 3, 4, 3, 3, 3, 4, 4, 3, 3, 3
  ],
  "environments": [
    [401.5, 101, 4],
    [233.5, 114, 4],
    [404.5, 113, 5],
    [160.5, 87.5, 10],
    [154.5, 126, 5],
    [144.5, 133.5, 9],
    [459, 139, 7],
    [561.5, 188, 4],
    [131.5, 192, 4],
    [507.5, 196, 4],
    [160, 132, 8],
    [129.5, 251, 4],
    [481.5, 241.5, 9],
    [473.5, 262, 5],
    [171, 273.5, 6],
    [438, 274.5, 6],
    [193.5, 293, 4],
    [652.5, 304, 4],
    [507.5, 327, 5],
    [216.5, 336, 5],
    [308.5, 354, 5],
    [152.5, 355, 5],
    [318, 352, 7],
    [254.5, 373, 5],
    [439.5, 438, 4],
    [636, 425.5, 6],
    [443.5, 424.5, 9],
    [544, 384, 1],
    [457.5, 448, 5],
    [333.5, 456, 4],
    [364.5, 477, 5],
    [646, 478, 7],
    [618, 490, 3],
    [588.5, 507, 5],
    [384, 511.5, 6],
    [433, 542, 3],
    [449.5, 558, 4],
    [516, 516, 10],
    [522, 555, 2]
  ],
  "organisms": [],
  "interactions": []
}
