{
  "rows": 20,
  "columns": 20,
  "terrains": [
    6, 7, 7, 7, 7, 7, 7, 7, 7, 7, 7, 7, 7, 7, 7, 7, 7, 7, 7, 5, 3, 6, 7, 7, 7,
    7, 7, 7, 7, 7, 7, 7, 7, 7, 7, 7, 7, 7, 5, 12, 3, 10, 15, 1, 15, 1, 1, 1, 1,
    1, 1, 1, 1, 1, 1, 1, 1, 1, 11, 12, 3, 0, 14, 0, 0, 0, 13, 0, 0, 0, 13, 0, 0,
    0, 0, 0, 0, 0, 0, 12, 3, 0, 0, 0, 14, 0, 0, 0, 0, 0, 0, 0, 0, 0, 14, 0, 0,
    0, 0, 12, 3, 0, 13, 0, 0, 0, 0, 0, 13, 0, 0, 13, 0, 0, 0, 0, 13, 14, 0, 12,
    3, 0, 0, 0, 14, 0, 0, 0, 0, 0, 0, 0, 0, 0, 0, 0, 0, 0, 0, 12, 3, 0, 13, 0,
    0, 0, 0, 14, 0, 0, 14, 0, 0, 14, 0, 0, 0, 14, 0, 12, 3, 0, 0, 0, 0, 0, 14,
    0, 0, 0, 0, 0, 14, 0, 0, 0, 0, 0, 0, 12, 3, 0, 0, 14, 0, 0, 0, 0, 0, 14, 0,
    13, 0, 0, 0, 0, 0, 13, 0, 12, 3, 0, 0, 0, 0, 0, 0, 14, 0, 0, 0, 0, 0, 0, 0,
    14, 0, 0, 0, 12, 3, 0, 0, 13, 0, 0, 0, 0, 0, 0, 0, 0, 13, 0, 0, 0, 0, 0, 0,
    12, 3, 0, 14, 0, 0, 0, 0, 14, 0, 13, 0, 0, 13, 0, 0, 14, 0, 0, 0, 12, 3, 0,
    0, 0, 0, 0, 0, 0, 0, 0, 0, 0, 14, 0, 0, 0, 0, 13, 0, 12, 3, 14, 0, 0, 13, 0,
    0, 0, 0, 0, 0, 0, 0, 0, 0, 0, 0, 0, 0, 12, 3, 0, 0, 0, 0, 0, 0, 13, 0, 14,
    0, 13, 0, 0, 0, 14, 13, 0, 0, 12, 3, 0, 0, 14, 0, 0, 0, 0, 0, 0, 0, 0, 0,
    14, 0, 0, 0, 0, 0, 12, 3, 0, 0, 13, 0, 0, 14, 0, 0, 0, 14, 0, 0, 0, 0, 0, 0,
    0, 13, 12, 3, 0, 13, 0, 0, 0, 0, 0, 0, 0, 0, 13, 0, 0, 14, 0, 0, 0, 0, 12,
    10, 1, 1, 1, 1, 1, 1, 1, 1, 1, 1, 1, 1, 1, 1, 1, 1, 1, 1, 11
  ],
  "environments": [],
  "organisms": [
    [582, 563, 0],
    [415, 567, 0],
    [27, 567, 0],
    [219, 567, 0]
  ],
  "interactions": [
    {
      "x": 64,
      "y": 96,
      "width": 32,
      "height": 16,
      "data": {
        "type": "switch-map",
        "prompt": "enter",
        "map": "map-1",
        "playerX": 580,
        "playerY": 490,
        "playerDirection": "right"
      }
    },
    {
      "x": 128,
      "y": 96,
      "width": 32,
      "height": 16,
      "data": {
        "type": "switch-map",
        "prompt": "enter",
        "map": "map-2",
        "playerX": 40,
        "playerY": 100,
        "playerDirection": "left"
      }
    }
  ],
  "postProcessing": "desert"
}
